Κεινος δ' αὐ περι κηρι μακαρτατος ἐξοχον ἀλλων,

Κεινος (=ἐκεινος): Die (m ev nom) [verwijzend naar een persoon]
δ': en
αὐ: op zijn beurt
περι: over
κηρι: in het hart (o ev dat)
περι κηρι: bovenmate in het hart
μακαρτατος: (zeer) gelukkig (superl.)
ἐξοχον + gen: uitstekend boven
ἀλλων: de anderen (m mv gen)

"En die is op zijn beurt bovenmate gelukkig in het hart, uitstekend boven de anderen,"
-----
ὁς κε σ' εἐδνοισι βρισας οἰκονδ' ἀγαγηται.

ὁς: die (m ev nom)
κε: ἀν
σ': jou (acc)
εἐδνοισι (WB623.2): bruidsschatten (o mv acc)
βρισας + dat: overladen met (aor. ptc. act. m ev nom)
οἰκονδ': naar huis
ἀγαγηται: jij zal als bruid meenemen (con. med. 3 ev) [Coniunctivus in bijzin +ἀν, toekomst]

"die jou, overladen met bruidsschatten, als bruid mee naar huis zal nemen."
-----

Οὐ γαρ πω τοιουτον ἐγω ἰδον ὀφθαλμοισιν,

Οὐ: nog
γαρ: want
πω: niet
τοιουτον: zo'n ()
ἐγω: ik (nom)
ἰδον: ik zag (?)
ὀφθαλμοισιν: met mijn ogen (m mv dat)

"Want nog niet zag ik zo'n mooie met mijn ogen,"
-----
οὐτ' ἀνδρ' οὐτε γυναικα• σεβας μ' ἐχει εἰσοροωντα.

οὐτ': noch
ἀνδρ': een man (m ev acc)
οὐτε: noch
γυναικα: een vrouw (v ev acc)
σεβας: verbazing (o ev nom)
μ': mij (acc)
ἐχει: het heeft (act. 3 ev)
εἰσοροωντα: terwijl ik met bewondering kijk (prs. ptc. act. m ev acc)

"noch een man, noch een vrouw: verbazing heeft mij terwijl ik met bewondering kijk."
-----
Δηλῳ δη ποτε τοιον ᾽Απολλωνος παρα βωμῳ

Δηλῳ: Op Delos (v ev dat)
δη: [Maakt niet uit]
ποτε: ooit
τοιον: zo'n mooie (o ev acc) [Volgende zin]
᾽Απολλωνος: van Apollo (gen)
παρα + dat: bij
βωμῳ: het altaar (m ev dat)

"Ooit, op Delos, bij het Altaar van Apollo,"
-----
φοινικος νεον ἐρνος ἀνερχομενον ἐνοησα•

φοινικος: van een dadelpalm (v ev gen)
νεον: jonge (o ev acc)
ἐρνος: stam (o ev acc)
ἀνερχομενον: oprijzend (med. ptc. o ev acc)
ἐνοησα: ik zag (aor. act. 1 ev)

"zag ik een zo'n mooie jonge stam van een dadelpalm, oprijzend: "
-----
ἠλθον γαρ και κεισε, πολυς δε μοι ἑσπετο λαος

ἠλθον: ik ging (aor. act. 1 ev)
γαρ: want
και: ook
κεισε: daarheen
πολυς: veel (m ev nom)
δε: en
μοι: met mij (dat)
ἑσπετο (van ἑπομαι): ging mee (aor. med. 3 ev)
λαος: krijgsvolk (m ev nom)

"want ik ging ook daarheen, en met mij ging ook veel krijgsvolk mee"
-----
την ὁδον, ᾑ δη μελλεν ἐμοι κακα κηδε' ἐσεσθαι.

την ὁδον: op die tocht
ᾑ: waarlangs
δη: dan
μελλεν ἐσεσθαι: te wachten zou staan
ἐμοι: voor mij (dat)
κακα: vreselijke (o mv nom)
κηδε': ellende (o mv nom)

"op die tocht, waarlangs dan voor mij vreselijke ellende te wachten zou staan."
-----
῾Ως δ' αὐτως και κεινο ἰδων ἐτεθηπεα θυμῳ,

῾Ως: op die manier
δ': En
αὐτως: juist [Versterkt ῾Ως]
και: ook
κεινο: die (o ev acc)
ἰδων: omdat ik kijk (aor. ptc)
ἐτεθηπεα: ik ben verbaasd (perf. act. 1 ev)
θυμῳ: in mijn geest (m ev dat)

"En op die manier ben ik ook, omdat ik kijk, verbaasd in mijn geest,"
-----
δην, ἐπει οὐ πω τοιον ἀνηλυθεν ἐκ δορυ γαιης,

δην: lange tijd
ἐπει: omdat
οὐ: niet
πω: nog
τοιον: zo'n (o ev nom)
ἀνηλυθεν: het rees op (aor. act. 3 ev)
ἐκ + gen: uit
δορυ: stam (o ev nom)
γαιης: de aarde (v ev gen)

"lange tijd, omdat zo'n stam nog niet uit de aarde oprees,"
-----
ὡς σε, γυναι, ἀγαμαι τε τεθηπα τε δειδια τ' αἰνως

ὡς: zoals
σε: u (acc)
γυναι: vrouw
ἀγαμαι: ik bewonder (u) (athem. med. 1 ev)
τε: en [τε erna is hetzelfde al και ervoor]
τεθηπα: ik ben verbaasd (perf. act. 1 ev)
δειδια: ik ben bang (perf. act. 1 ev)
αἰνως: vreselijk (bijw.)

"zoals u, vrouw, en ik bewonder u, en ik ben verbaasd, en ik ben vreselijk bang"
-----
γουνων ἁψασθαι• χαλεπον δε με πενθος ἱκανει.

γουνων: uw knieën (o mv gen)
ἁψασθαι: vast te pakken (aor. med. inf.)
χαλεπον: zwaar (o ev nom)
δε: maar
με: mij (acc)
πενθος: verdriet (o ev nom)
ἱκανει: het heeft mij bereikt (prs. act. 3 ev)

"uw knieën vast te pakken: maar een zwaar verdriet heeft mij bereikt."
